1111111111111
1001000000E01
1000011110C01
1P00111000001
1111111111111